________________________________________________________________________
___#############___########__#_____#____##____######__########__________
___#___________#___#_________#_____#___#__#___#_______#_________________
___#___________#___#_________#######___####___######__######____________
___#___________#___#_________#_____#__#____#_______#__#_________________
___#___________#___########__#_____#__#____#__######__########__________
___#___________#________________________________________________________
___#___________######################################################___
___#___________#____________________________________________________#___
___#___________#____________________________________________________#___
___#___________#____________________________________________________#___
___#___________#____________________________________________________#___
___#___________#____________________________________________________#___
___#___________#___________#________________________________________#___
___#___________#############________________________________________#___
___#________________________________________________________________#___
___#________________________________________________________________#___
___#________________________________________c_______________________#___
___#________________________________________________________________#___
___#________________________________________________________________#___
___#________________________________________________________________#___
___#________________________________________________________________#___
___##################################################################___
________________________________________________________________________


________________________________________________________________________
__####################################################################__
__#__________________________________________________________________#__
__#__________________________________________________________________#__
__#______###############################__#####################______#__
__#_____________________________________#_____________________#______#__
__################################_######################_____#______#__
__#__________________________________#________________________#______#__
__#______________________________#___#________________________#______#__
__#______________________________#___#___#___############_____#______#__
__#______________________________#_______#__________#H________#______#__
__#______________________________#___#####___#______#_________#______#__
__#______________________________#___________#______#_________#______#__
__#______________________________#____#______#______#_________#______#__
__#______________________________#____#______#______#_#########______#__
__#_________________________#____#____#______#______#____#c__________#__
__#__##########_____________#____#____########______#____#############__
__#_____#_____#_____________#____#__________________#________________#__
__#_____#___________________#____#__________________#________________#__
__#_____#_____#_____________#____####################________________#__
__#_____#_____#_____________#________________________________________#__
__#_____#_____#_____________#________________________________________#__
__####################################################################__
________________________________________________________________________



________________________________________________________________________
___vvvvvvvvvvvvvvvvvvvvvvvvvvvvvvvvvvvvvvvvvvvvvvvvvvvvvvvvvvvvvvvvv####
___>_______________________________________________________________<___#
___>_______________________________________________________________<___#
___>^^^^^^^^^^^^^^^^^^^^^^^^^^^^^^^^^^^^^^^^^^^^^^^^^^^^^^^^^__^^^^<___#
___>_______________________________________________________________<___#
___>_______________________________________________________________<___#
___>^^^^^^^^^^^^^^^^^^^^^^^^^^^^__^^^^^^^^^^^^^^^^^^^^^^^^^^^^^^^^^<___#
___>_______________________________________________________________<___#
___>___________________________________________________________________#
___>^^^^^^^^^^^^^^^^^^^^^^^^^^^^^^^^^^^^^^^^^^^^^^^^^__^^^^^^^^^^^^<___#
___>_______________________________________________________________<___#
___>_______________________________________________________________<___#
___>^^^^^^^__^^^^^^^^^^^^^^^^^^^^^^^^^^^^^^^^^^^^^^^^^^^^^^^^^^^^^^<___#
___>_______________________________________________________________<___#
___>_______________________________________________________________<___#
___>^^^^^^^^^^^^^^^^^^^^^^^^^^__^^^^^^^^^^^^^^^^^^^^^^^^^^^^^^^^^^^<___#
___>_______________________________________________________________<___#
___>___________________________________________________________________#
___>^^^^^^^^^^^^^^^^^^^^^^^^^^^__^^^^^^^^^^^^^^^^^^^^^^^^^^^^^^^^^^<___#
___>_______________________________________________________________<___#
___>_______________________________________________________________<___#
___^^^^^^^^^^^^^^^^^^^^^^^^^^^^^^^^^^^^^^^^^^^^^^^^^^^^^^^^^^^^^^^^^####
________________________________________________________________________



________________________________________________________________________
########################################################################
#__________________________________________________________________#___#
#__________________________________________________________________#___#
#______________________________________________^^^^^^^^^^^^________#___#
#_____#####################################################________#__<#
#_________________#____________________________#______________________<#
#_________________#____________________________#__________#________#__<#
#________________#c__#_________________________#__________#________#___#
#________________#####_________________________#_<^^^^^^>_#________#___#
#________________________________________________<______>_#________#___#
#_______________######_________________________#_<______>_#^^^^^^^^#___#
#______________#_____#_________________________#_<vvvvvvv_##########___#
#______________#_______________________________#__________vvvvvvvvvv___#
#_______vvvvvvvvvvvvvvvvvvvvvvvvvvvvvvvvvvvvvvv#______________________<#
#___________________________c<____________________________________#>___#
#_________####################___________^^^^^^#^^^^^^^^^^^^^^^^__#____#
#___________________________c<___________<_____#################_<#_^^^#
#_________####################___________<___________________#>________#
#___________________________c<___________<___________________#>________#
#_________####################___________<___________________#>________#
#________________________________________<___________________#>^^^^^^^^#
^^^^^^^^^^^^^^^^^^^^^^^^^^^^^^^^^^^^^^^^^<___________________###########
_________________________________________<______________________________



########################################################################
#______________________________________________________________________#
#______________________________________________________________________#
#______________________________________________________________________#
#________________####_______________________________####_______________#
#______________##____##___________________________##____##_____________#
#_________________cc___#_____________________________cc___#____________#
#_____________#________#_________________________#________#____________#
#______________##____##___________________________##____##_____________#
#________________####______________#________________####_______________#
#___________________________________#__________________________________#
#____________________________________#_________________________________#
#_____________________________________#________________________________#
#___________#_____________________####_____________________#___________#
#___________#______________________________________________#___________#
#____________#____________________________________________#____________#
#_____________##________________________________________##_____________#
#_______________####________________________________####_______________#
#___________________#######__________________#######___________________#
#__________________________##################__________________________#
#______________________________________________________________________#
#______________________________________________________________________#
#______________________________________________________________________#
########################################################################



########################################################################
#______________________________________________________________________#
#______________________________________________________________________#
#_##########################################___________________________#
#____________________________________________#######___________________#
#___________________________________________________#####______________#
########################################>________________####__________#
#____________________________________________________________###_______#
#_______________________________________________________________##_____#
####################################################>____##_______#____#
#__________________________________________________________________#___#
#__________________________________________________________#HH#_____#__#
#######################################################>___####_____#__#
#__________________________________________________________#__#_____#__#
#___________________________________________________________________#__#
####################################################>____##________#___#
#_________________________________________________________________#____#
#_______________________________________________________________##_____#
########################################>____________________###_______#
#________________________________________________________####__________#
#___________________________________________________#####______________#
#_____________________________________________######___________________#
############################################___________________________#
########################################################################



########################################################################
#______________________________________________________________________#
#______________________________________________________________________#
#______________________________________________________________________#
#______________________________________________________________________#
#__#####################___##########################___#############__#
#__#_______________________#____________________________#______________#
#__#_______________________#____________________________#______________#
#__#_______________________#____________________________#______________#
#__#_______________________#____________________________#______________#
#______________________________________________________________________#
#__#####################___##########################___#############__#
#__#_______________________#____________________________#______________#
#__#_______________________#____________________________#______________#
#__#_______________________#____________________________#______________#
#__#_______________________#____________________________#______________#
#______________________________________________________________________#
#__#####################___##########################___#############__#
#__#_______________________#____________________________#c_____________#
#__#_______________________#____________________________#______________#
#__#_______________________#____________________________#______________#
#__#_______________________#____________________________#______________#
#______________________________________________________________________#
########################################################################



########################################################################
#______________________________________________________________________#
#__________###################################___###################___#
#__________#_____________________________________#_________________#___#
#__________#_____________________________________#_________________#___#
#__________#_____#############################___#____######_______#___#
#__________#_________________________________#___#____#_c__________#___#
#__________#_________________________________#___#____##############___#
#__________#######################___#########___#_____________________#
#________________________________________________#_____________________#
#____________________________________________#___#######################
#__________#__<#########################>____#_________________________#
#__________#__<#_______________________#>____#_________________________#
#__________#__<#______________c________#>____#_____#################___#
#__________#__<#_______________________#>____#_____#___<#__________#___#
#__________#__<#_______________________#>____#_____#___<#__________#___#
#__________#__<##########__#############>____#_____#___<#_^^^^^^^______#
#____________________________________________#_____#___<#_##############
#____________________________________________#_____#___<#______________#
#__________#_________________________________#_____#___<#______________#
#__________#_________________________________#######___<#______________#
#__________#___________________________________________<#______________#
#__________#^^^^^^^^^^^^^^^^^^^^^^^^^^^^^^^^^^^^^^^^^^^^#^^^^^^^^^^^^^^#
########################################################################
